1111111111111
100100C0000C1
1C00011111001
1P0011E000E11
1111111111111