1111111111111111111
10000000C0100I01111
1001011111000001111
10010000C0000000111
100100000000I0IE111
100011111011001PC11
1111111111111111111