1111111111111111111
10000000C0100I01111
1001011111000E01111
10010P00C100I001111
1001000000000000111
1000111110110110C11
1111111111111111111